111111111
111111111
110010011
100000001
100000001
110000011
111000111
111101111
111111111
