10111110
10100101
11111111
10111110
11100111
11111101
10111110
00011111
