1110111010
1010010110
1111011110
1011001101
1111111111
1111110111
1011111011
1111111111
1001110111
0111001111